EA ./texture/Sides_wall.xpm
NO ./texture/NO_wall.xpm
SO ./texture/SO_wall.xpm
WE ./texture/Sides_wall.xpm

C 65,65,230
F 130,130,133

11111111111111111111111111111
    100000000011000000000001
   10110000011100000000S0011
   10010000000000000000000011111
111111111011000001110000000000001
100000000011000001110110111111111
11110111111111011100000010001
11110111111111011101010010001
1100000011010101110000000111
10000000000000001100000010001
10000000000000001101010010001
110000011101010111110110100111
11110111 1110101 101111010001
11111111 1111111 111111111111