EA ./texture/ciao.xpm
NO ./texture/ciao.xpm
SO ./texture/ciao.xpm
WE ./texture/ciao.xpm

C 2,2,2
F 1,23,23

11111111111111111111111111111
    1000000000110000000000001
   1011000001110000000000011
   10010000000000000000000011111
111111111011000001110000000000001
100000000011000001110111111111111
11110111111111011100000010001
11110111111111011101010010001
11000000110101011100000N0011
10000000000000001100000010001
10000000000000001101010010001
110000011101010111110111100111
11110111 1110101 101111010001
11111111 1111111 111111111111