EA ./texture/Sides_wall.xpm
NO ./texture/NO_wall.xpm
SO ./texture/SO_wall.xpm
WE ./texture/Sides_wall.xpm

C 65,65,190
F 130,130,133

1111111111111111111
1000000000000000001
100000000000N000001
1111111111111111111